ilst-cprt=com.coremedia.iso.boxes.apple.AppleCopyrightBox
ilst-\u00A9cmt=com.coremedia.iso.boxes.apple.AppleCommentBox
ilst-desc=com.coremedia.iso.boxes.apple.AppleDescriptionBox
ilst-covr=com.coremedia.iso.boxes.apple.AppleCoverBox
ilst-\u00A9alb=com.coremedia.iso.boxes.apple.AppleAlbumBox
ilst-\u00A9gen=com.coremedia.iso.boxes.apple.AppleCustomGenreBox
ilst-\u00A9grp=com.coremedia.iso.boxes.apple.AppleGroupingBox
ilst-\u00A9wrt=com.coremedia.iso.boxes.apple.AppleTrackAuthorBox
ilst-aART=com.coremedia.iso.boxes.apple.AppleAlbumArtistBox
ilst-tvsh=com.coremedia.iso.boxes.apple.AppleShowBox
ilst-stik=com.coremedia.iso.boxes.apple.AppleMediaTypeBox
ilst-pgap=com.coremedia.iso.boxes.apple.AppleGaplessPlaybackBox
ilst-tmpo=com.coremedia.iso.boxes.apple.AppleTempBox
ilst-\u00A9nam=com.coremedia.iso.boxes.apple.AppleTrackTitleBox
ilst-ldes=com.coremedia.iso.boxes.apple.AppleSynopsisBox
ilst-\u00A9ART=com.coremedia.iso.boxes.apple.AppleArtistBox
ilst-cpil=com.coremedia.iso.boxes.apple.AppleCompilationBox
ilst-purd=com.coremedia.iso.boxes.apple.ApplePurchaseDateBox
ilst-\u00A9too=com.coremedia.iso.boxes.apple.AppleEncoderBox
ilst-sfID=com.coremedia.iso.boxes.apple.AppleStoreCountryCodeBox
ilst-gnre=com.coremedia.iso.boxes.apple.AppleStandardGenreBox
ilst-tves=com.coremedia.iso.boxes.apple.AppleTvEpisodeBox
ilst-tvsn=com.coremedia.iso.boxes.apple.AppleTvSeasonBox
ilst-soal=com.coremedia.iso.boxes.apple.AppleSortAlbumBox
ilst-sonm=com.coremedia.iso.boxes.apple.AppleSortTitleBox
ilst-tven=com.coremedia.iso.boxes.apple.AppleTvEpisodeNumberBox
ilst-trkn=com.coremedia.iso.boxes.apple.AppleTrackNumberBox
ilst-\u00A9day=com.coremedia.iso.boxes.apple.AppleRecordingYearBox
ilst-----=com.coremedia.iso.boxes.apple.AppleGenericBox
ilst-akID=com.coremedia.iso.boxes.apple.AppleStoreAccountTypeBox
ilst-rtng=com.coremedia.iso.boxes.apple.AppleRatingBox
ilst-tvnn=com.coremedia.iso.boxes.apple.AppleNetworkBox
ilst-apID=com.coremedia.iso.boxes.apple.AppleIdBox
-----mean=com.coremedia.iso.boxes.apple.AppleMeanBox
-----data=com.coremedia.iso.boxes.apple.AppleDataBox
-----name=com.coremedia.iso.boxes.apple.AppleNameBox
